>P<##PPPPP
#PPPPPP#PP
PPPP#####P
P##PP#PPPP
PPPPPPP#PP
###P#PP#P#
PPPPPPPPP#
P#PPPPPPPP
P#P##PP##P
PPPPPPPPPP
