PPPPP#PPPP
P##PPP#P#P
P#PPPPPPPP
PPP###PPP#
##PPPPPPPP
PP##PPPP#P
#PP#P##PPP
PPPPP#PP#P
PPP###PP#P
PPPPPPPP#A
