##########
####VVPPPP
###PPPP#PP
PPPP#PP#P#
PP##P#PPP#
#P#PP##PP#
#PPP###PP#
#PPPPPPPPP
#PP#PPPPPP
##PPPP#P##
