PP#PPP#>PP
PP#PPPP##P
#PPP#PP##P
PP#PP#PPPP
P###P#PP##
PP#PP#PPP#
#PP#PP##PP
#PPP#PPPPP
##PP#PP###
###PPP####
