##PPP###P<
##PPPPPPP#
PPPP#PPPP#
P##PPP##PP
PPP#>PPPPP
P#P###PPPP
PPPPPPPPPP
#PP#PPP#PP
#PP#PPPP#P
#PPPP##PPP
