#PP#PPPPPP
#PPPP#P#PP
VPPPP#PPPP
PPP#PP#PP#
P#PPPP#P##
P##P#PPPPP
PP#P#P##PP
#P#P#PPPP#
PPPP#PPPPP
P#PPPPP#PP
