#PP<###PPP
#PPPP#PPPP
#P#PPPPP#P
VP#PP#P#PP
PPPPP#PPP#
##P#PPPPPP
##PPPPPPPP
##P#P#PPPP
PPPPPPPP##
P##PPPPPPP
