PP#PPPP#PP
P##P##PPP#
PPPP#VPPPP
PPPPPPP#PP
PPPP##P#PP
PP#PPPPPP#
PP#PP###P#
#PPP#PPPPP
#PPP#PPPPP
#PP#PP#PPP
