###PP#PPP#
##PPPPP#P#
#PPPP#PPPP
#P##PPPPPP
#PPPP###P#
#PPPP#PPP#
#PP#PPPPP#
#PPPPPPPPP
#PP#PP#P#P
#>A#PP#PPP
