VPP######PPPP#PPPPPP
PPP<####PP##P#P###PP
P#PPPPPPPP###PP##PPP
PPPPA#PP####PPP#VPP#
PP#P#PPPP##PP#P#PPA#
PPPPP###PPPPPPPPPP##
P#P#PPP#PP#PPP###PP#
PP##PP##P#PPP###PPP#
PPPPPP##PPPP#PPPP#PP
PPPPPP###PPPPPP#P#PP
PP#PPP###PPPPPPPP#PP
PP###PP#PPP###P#PPPP
PP###PPPP#PPP#P#P#P#
PPP###P##PP#PPPPPPP#
PPPPPPPPPP######PPP#
PPPP#P##P####P#PPP##
#PPP#PP#P#PPPPPPPPP#
##P#PPPPPPP#P##PPPP#
PPPPPPP#P#PPPPPPPPPP
P#PP#PP#P#PPP#P###PP
