PP#P<#P#PP
P#PPPPPPP#
P#P######P
PPP#VP##PP
#PPPPP##PP
PP###PPPPP
PPPPPPPP#P
####PPPP#P
####P#PPPP
####PPP#PP
