PPPP##PPP#
PPPP#PPPP#
PPPPPPP#P#
PPP#####PP
P#PPPPPPPP
P###PP#PPP
PPP<#P##PP
#PPPPP#PPP
PP#P#PPP#P
A#PP####PP
