PPPP#PPPPP
P##PPP###P
PPPPPPPPPP
PP#P#P####
PP#PPPPPP#
PPPPPPP#PP
PPPP##P##P
PPPP#PP##P
PPPPPPPPPP
>PPP####A#
