P#PPP#PPPP
PPP#PPPP#P
#PPPPPPPPP
PPPA##PPPP
P#P##PP#PP
PPPPP#PPPP
#P##PPP##P
PPP##>PPPP
PPP#P#P##P
##PPP#PPPP
