PPPPP#PPPP
####PPP##P
PPPPP####P
PP#PPPP#PP
PPP#PPP#PP
##PP#PPPP#
###PP#PPP#
###PPPP###
###PPP####
##########
