PP####P#PPPPPPPP####
PPPPPPPPP##PPA#P####
PP#>>PPPPPPP###PPP<#
PPP##P#PP#P###PPPPP<
PPPPPPPPP#P###P#P#PP
PPPPP#####PP#PP#P#PP
P##PPPPPPPPP#PP#PPP#
PP##PP##P#PPPP#PPP##
PPPPPP##PPP#PPPP#PPP
###PPPP#PPPPPP####PP
#PPPP#PP##PPPP####PP
PPPPPPPPPPPPP######P
PP###P##PP#PPP####PP
PP###PPPP#PP#PPPPPPP
PP###PPPP#PPP#PP#P##
PPPPPPPPP#P#PP##PPPP
#PPPPP#PPPPPPPPPPP#P
PPPPP#PPP###PPP#PP#P
P#P#PP##PPPPP#P#PP#P
PPP##PPPP#PPP#PPPPPP
