PPPPP#####
PP#>P###V#
PP##P###P#
P#PPP###P#
P#P#P###P<
PPPPP###PP
PP##PPPPPP
PP#PPPPP##
#P#P######
#PPP######
