PPPPPPPPPPPPPPPP####
P##PP##PPP###PPP####
PPPPPPPP######PPP###
PPPP#PPPPP####PPP###
##P###PPPP#P<#PPA###
#PP####PPPPPPPP##VP#
#P#####PP##PPP#PPPP#
#PP####PP#PP###PPPP#
#PPPPPPPP#PPP##P#P##
##P#PPPPP###P##P#P##
PPPP##PPPPPPP#PP#P##
P#PP##PPPPP#PPPP#PP#
PP#P#PP#####P##P#PP#
PPPPPPP#####PPPP##P#
PPPPPP#####PPPPPPPP#
#PP###PPPPPPPPPPP#PP
#PPP#PP#####PP####PP
###PPPP######PP###PP
#############PPP###P
###############PPPPP
