PPP#PPPP##
P#PPP##P##
P#P#PPPPP#
P#PPPPP#P#
PPP#PPP#PP
##A#PPPPPP
PP#PP#P##P
#PPP#PP#PP
##P#PPPPPP
##PPPPPP##
