>PPPP#PPPP
#PPPP#A#PP
PP#PP###P#
PPPPP#PPP#
PP##PPPPPP
#PPPPP###P
P#P#PP##PP
P#PPPP##PP
P#P#PP#PP#
PPP##PP#PP
