#PPP##VPPP
PP#PPPPP#P
P#PPPP#PPP
P#PP#PPPPP
P#PP####P#
PPPPP#PPPP
###PP#PP#P
####PPP#PP
#####P#PPP
#####PPP##
