#PPPPPP#PP
#PP#PPPPPP
PPP#PP##PA
P#P#PP#PP#
P#PP#P#PPP
PP#PPP#P#P
#P#PP#P#PP
PPP#PPP#PP
P#P##P#PPP
PPPP#PPP##
