#VP#PPPP##
#PPPP#PPPP
PP##P#P##P
#P#PP#PP#P
VPPPPPPPPP
PP#P#P#P##
PPPPPP#P##
PPP#PPPPP#
#P##PPP#P#
#PPPP#PPP#
