#PPPP#P<#P
#PP#PPPP#P
#PPPP##P#P
###PPPPPPP
##PPPPPP##
##PP#PPPPP
PPPPPPPP#P
PP#PP##PPP
PPPP#PPP##
#####PPP##
