P#PPP##PPP
PPP#P#PP#P
#PPPPPPPPP
#P#P##>P#P
PPPP###PPP
PPPPPPPPPP
PPPPPPPP#P
PPPPPPPPPP
###PP#PP#P
####P#PPPP
