#PPPP##PPPPPPP###VP<
PP#PP<#PP##PPP###PP#
P#PPPPPP#PPPPPPP#PP#
PPP#PP##VP#PP#>PPPP#
###PPPPPPPP#PP#P#PP#
##PPPPP#PPPPPPPPP#PP
#PP#P#PPP#PP#PP#PPPP
PP#PPP#PPPPPPPP##PPP
P#PPPP##PP##PPP#PP#P
PPP#PPPPPP#P#P#PPPPP
##P#P#PPPP#PPPPPPPP#
####PP##PP#P#P#P#P##
##PPP#PPPPPP#PPP#PP#
PPP#P#PPPP#PPP#PPPP#
PP##P#PP#P#PPPPPP#PP
#P##P#P#PPPP#P###PPP
PP#PP#PPPP#P#PPPPPPP
P##P#PPPPPPP#P##PPP#
P#PP#PPPP##P#P###PP#
PPPPPP#PP##PPP###PPP
