#VPP#PPP##
#PPPPPPPPP
PPPP###P#P
P##PPPPPPP
P##P#PPPPP
PP#PPPP#P#
PPPPPPP#PP
P##P#PPPP#
P#PPPP##PP
PPP#P###PP
