#PPPP###PP
PPPPPPPPP#
P#PPPPPPPP
A#P##PP##P
#PP##PPP#P
PPPP##PPP#
P##PPPP#PP
PPPPPPPP#P
####PPPP#P
PPPPPP##PP
