P<##PPPP##
PPPPPP#PP#
P#P###P#PP
PPPPPPP##P
#P##P#P##P
PP##P#P#PP
PPPPPPPPP#
P#PP###PP#
PP##PPPPP#
#PPPPPP#PP
