PPPPPPP#PP
PPPPP#PPP#
P#PPPPPPPP
P#PPP####P
PPP#PPP<#P
PPPPPPPPPP
##PP#P#P#P
P#PPPPPPPP
P#PP#PPPPP
PPP##PP#PP
