VP##VP####
PPPPPP#PPP
P#PP#P#P#P
PPPP#PPP#P
#PPP#PP##P
###P#PPPPP
###PPPPPP#
##PPP##PP#
#PPP###PP#
PPPP####PP
