PPP#VP##VP
P#PPPPPPPP
#PPP##PPP#
PPPPPPPPPP
P#P##PPPPP
P#PPPPP#PP
P#PPP#PPPP
PPPP##P#PP
#PPP#PP#PP
##PPPPP#PP
