##PPPPP#P<
PPP###PPPP
P#######PP
PPPP###PP#
PPPPPPPPPP
#PPPPPP##P
PP###P#PPP
PPPPPPPP##
PPPPPPPP##
P#PPPP####
