#PPPPPPP##
PPPA#P#PPP
P#P#PPPPPP
P#PPPPPP##
#PP##PPPPP
PPPP#PPP#P
P##PPPPPPP
P#PPPP#PP#
P#PPP#PPP#
PPP#PPP###
