VPPPP##PPP
PP#PP#PP#P
P###PPPPPP
PPP##PP#PP
#PPP#P#PP#
P##PPPPP##
PP#PP##PPP
#PPPPPPPPP
PP#PPPPP#P
P#PP###PPP
