#VPPPP#PPP
PPP#PPPP#P
P#PPP#PP#P
PP##PPP#PP
>PP#PPPPP#
##PPP#####
###PPPP###
##PP##P###
PPP##PP###
PPPPPPP###
