#PP####PP<
#PPPPPPPPP
PP#P#PPPPP
PPPPP#P##P
PPP#PPPPPP
P####P#PPP
PPP##PPPPP
P#PP#PPPPP
P##PPP#PP#
PPPPP#PP##
