PPPPP#PPPP
PA##PPP#PP
P###P#PP#P
PPPPPP#PPP
#PPPPPPPPP
PPPPPPPPP#
PP##P####P
PP#PP###PP
PPPPPPPPP#
##PPPPP#PP
