###VPPPP#P
##PPPP#PPP
#PP##PP##P
#P#PPPPPPP
#PPP#PPP#P
PP#PPPPPPP
#P#PP##P##
PPPP##PPPP
PP#PPPP#PP
PPPPPPPPPP
