#VPPPPPPPP
#PP#P####P
#>PPP####P
###PP####P
PPP#P###PP
P#PPP###P#
P###P###PP
PP##PPP#>P
#PPPPPPP#P
###PPP#PPP
