#PP<##PPPP
PPPPP#PP#P
PP##P#PPPP
PPPPPPP#PP
PPP#PPPP#P
###PP#PPPP
##PP#PP#P#
#PPPPP#PPP
PP#P#PPP#P
PPPPPPPPPP
