#PPPPPPPP#
#P#PP#PPPP
PPPPP#PPPP
PPP#PPP#PP
PPPPPPPPP#
#PPPP#PPPP
#PP#PPPP#P
PPPP#P#PPP
PP##PP#PP#
>PPPP##PPP
