PP#PPP####PPPPPPP##V
#P#A#PP###PA#P##PPPP
#PP##PPPPPP#PPPPP#P#
##PPPPPP###PP###PPPP
##PPP##P##PP#PPP#P#P
PPP#PPPP##P#PP#PPPPP
PPPPPPPPPPPPP##P####
PP##PPPP#P#PPPPP#PP<
PPP#PP#PPP#PPP#PPPP#
P#PPP##P#PPPPPPPPPA#
PPPP##PPPPPPP#P#PP##
PPPP##P#P#PPP#PPP###
#PPPPPP#PPP#P#P#####
##PPPPPPPPP#PPPPPPPP
PP##PPPPPPPPP#P#PP#P
PPPPPP#PPPPPPPP#PPPP
PP##PP#P##P#PP###PPP
PPPP#P#P#PPPPP###PPP
###PPPPPPP#P#PP####P
###PPPPPPPPPP#PPPPPP
