#PPPPPPP##
PPPP###PP#
PPPPPP##PP
P#P#PPPPPP
P#PP#>PP##
#PPP###P##
PPPPPPPPPP
PPPP#P##PP
###P#P##PP
###PPPPPP#
