PPPP<#####
P#PPP#####
PPPPP#####
#PPPP#####
#>PPPP####
##P#PPPPPP
#PPPP####P
PPPPPPPPPP
P##PA#####
PPPP######
