PPPP#>P#PP
P#PP##PPP#
PPPPPPP#P#
P#PPPPP#P#
P###P#PPPP
PPPPP##P#P
#PPPPPPP#P
#P###PPPPP
#PPPPPPPPP
##PP###PPP
