#####PPP##
VPPPPPPP##
PPPPPPPPPP
##P#PPPP#P
PPPPPP#P#P
PP#P##PPPP
PPPPPPP#P#
#PP###PPPP
##P#PPP#PP
##PPPPPPPP
