PPPP######
PP#PP#####
>PPPPPP###
#PPPP#PP##
VPPA###PPP
PPP####PPP
P#######PP
PP###PPPPP
PPP#PP####
##PPP#####
