VPPPPPP#PP<#PP<##PPP
PPP#P#PPPPPP#PPPPP#P
PPPPPPPPP##P#PPP##PP
#PPPPP##PPPPPPPPPPP#
PP#PPPPPP##P#PPP#PPP
P##PP#P#PPPPPPPPPPPP
PPPP##PPPPPP#PPA#PA#
##PPPPPP##PPPPP##P#P
PPPPP#P#P###PP#P#PPP
P#PPPPPPPPPPPPPPPP##
PPPPPPPP#PP##PP#####
PP#PPPPPP#####PP####
PPPPPP##PP##PPPPPPPP
PP#PP#PP#PPPPPP#PP#P
P#PPP#PPP#P#PPPP#P#P
P#PP##P##PPPP##P##PP
PPPP#PPPPP#PPPPPP#PP
#PPPP##P###P##PPPPPP
###PPPP##PPP##PPPP#P
#####PPPPPP###PP#PPP
