#PPP<#PPPP
PP#PP#PP#P
P###PPP#PP
PPP#PP#PPP
##PPP##PP#
PPP##PPPPP
P##P#P###P
PP#P#PPPPP
#PPPP#PPPP
###PPPP#P#
