VV####PPPPP##VPP####
PPPPPPP#PPP#PPPP#PPP
P#PPPP#VPPP#P##P#P#P
P#PPPP#PP#PPP#>PP##P
P#PPPP#PP#P#PP##PPPP
P#P#PPPP#PP##P###PP#
P#P##P###P#PPP##PPP#
PPP##PPPPP#PPPPPP###
P#PPP#PP#P#P#PP#PPP#
PP##P#PP#PPPP#PPP#PP
PPPPP#PPPPPPPPPP#P#P
PP#PPPPPP#PPPPPP#P#P
PP#PP###PPPPP##PPPPP
PPPPP##PPP##P##P#PP#
PPPPPPPPPP##PPPPPP#P
P#P#PPP#PP#PP#PP#PPP
P#PPPPPPP#PPPP#P#P##
PPP#PPPPP#P###PPPPPP
PP#PPPP#PPPP#PP##PPP
PPPPPPP#PP#PPPP#####
