##PPPPPPPP
#PP##A#P#P
PPP###PPPP
PP#P#PPP#P
P##PPPP#PP
PPPP#PPPPP
PPP#PPPPPP
##PP#PPPPP
PPPPP#PPP#
PPP#PPPP##
