#VPPPPPPP#
PPP#PPPPP#
P#PP###PPP
PPPPPP##PP
#P##PP#PP#
PPPPPP#PPP
P##PP#PPPP
P#PPP#PP#P
PPP#PPPP#P
#####PPPPP
