#PPP<#####
PP#PP#P###
P##PPPP###
PPPP######
PPP#PP####
PPPPPPP###
PPP#P#PPP<
P##PPP##PP
P#PP#PPPPA
PPPP######
