>P#####PPP
#PPPPPPP#P
#P#PPP#P#P
PP#PPP#P#P
PPPPPP##PP
#PPPPPPPP#
#PPPP##P##
#P##PPPP##
PPP#PPPPPP
P#PPPPPPPP
