####PPPP##
###PPP#PP<
###PPPPPPP
##PPPP#P#P
#PPPPPPP#P
#PP##PP##P
PP##PP###P
#PP#PP##PP
#P#PP##PP#
PPPP#PPP##
