##PPP##PPP
PPP#P#VPP#
P#P#PPPPP#
PPPPP##PP#
#PPPP#P#P#
PP###PP#P#
P#PP#PPPPP
P##P#PP##P
PPPPP#PP#P
##P#PP#PPP
