PPPPPP#PPP
PP###P#PPP
PP##PPPPPP
#PPPPP###P
V##P#####P
PPPPP####P
PPPPP####P
P#P#P####P
PPPPPPPP#P
##PPP##PPP
