PPPPPP#PP<
PP##PPPPPP
P#PP#PPPPP
PPP#P#P#PP
P#P#PPP##P
PPPP##PPPP
PP#P#PP###
PPPPPPP###
P#PP######
PPPP######
