##PPPP#PPP
##P#PPPPPP
##P#P#P#PA
##PPPPPPP#
#PPP###P#P
PP#PPPPPPP
P##P####P#
PP#PPPPPPP
#P#P#PP#PP
#PPPP#PPPP
