######PPPP
##VPPPP#PP
##PPPP#PPP
#PP#PPPPPP
PP#PPPP##P
P##PP#PPPP
PPPPP#P##P
#PP#P#P#PP
PP#PP#PPP#
P#PP#PPP##
