#########V
PPP######P
P#P####PPP
PPPPP##P##
PPP#PP#PP<
P#PPPPPPP#
P<##P##PP#
PPPPP###PP
P#P#PP###P
PPPPPPPPPP
