#PPPPPPP#P
#P#P#P#P#P
VP#PPPPPPP
PP##PPP###
PP###>P###
PP####PP##
PP<###PP##
PPPP###P##
###PP#PP##
###PPPPP##
