PPPP#PPPP#
P#PPPPP#P#
P<###PPPP#
PPPPPP#P##
PP#PPPPS##
PPPPP##PP#
PPP#PP##P#
P#PP#PP#PP
PP#PPPP##P
#PPPPPPPPP
