####SPPP##
####VP#P##
####PPPP##
####PP#P##
#S#VPP#P##
###PPPPPP#
##PP#PP#PP
PPP#PPP##P
P#P#S>P##P
PPPPP#PPPP
