PPPPPPPPPP##PPPP#SPS
P#PPPSPPPPPPPP#PPP#P
#VPPPPPP##P##PPPPP#P
PPP#P#PPS#PPPPS##PPP
PP#PP###P#P##P####P#
PP#PP###PPP#PP###PPP
P#PPPP##P#PPPPP#>P#P
P#PPPPPPPPP###PP#P#P
P#PPPP#P#PPPP<#P#PPP
P#P#PPPPPP##PPPP#P#P
P##PP#PP#PPPP##PPP#P
PP<##PP#>PPPP#PP#PPP
#PPPPPP##PPP##P#P##P
PPPPPPP##PPP#PPPPPPP
P#PPPPP#PP#PP#PPPPPP
PPPPPPPPPP##PP####PP
##P#PP##PPPP#P#P##PP
###PPPPPPP#PPP#PPPPP
PPPPP##P###P####P#P#
PP##PPPPPPPP####PPP#
