VPPPPPPPPP
PPP###PPPP
########PP
P#PPPPSPPP
PP##PPPPPP
#PPPPP#P#P
#P#PPPPPPP
PPPPPPP#PP
PPP###PP##
PPPPPP#PPP
