######PPP#
######P#PP
S#####P#PP
##VPPPPPPP
#VPP#S#P##
PPPP###P##
P#SP###P##
PPPPPP#PPP
PPP#>P#PPP
#####PPPPP
