PPP#PPP<#S
PPP#P#PP#P
PPP#PP#PPP
##PPPP#PPP
PPPPP#PPPP
P##P#PPP##
PPPPPPPPPP
###PPPP##P
###PP#PPPP
####PPPPPP
