PPPPPP##P<
P###PPPPPP
PPPP#PPP##
#PPPPP#PPP
PPA##PPP#P
P######PPP
PPPSP###P#
P#P#PPPPP#
PP###P##PP
SPPPPP###P
