####PPP#P<
###PPPPPPP
SPPPPP###P
#PPP######
SPPSPPPPPP
##PPP####P
##PPP<##VP
##PPPP#PPP
#####PPPP#
##########
