#S#####PPP
PPPPPP#P#P
PP#P#PPPPP
PP#P##PA#P
PP#PP#P##P
PP#PPPP#PP
PPP#P#PPPP
PPPPPPPPPP
PPPP#PPP#P
PPPP##PPPP
