P<#PPPPPPS
P##P#PPPPP
P##PPP#P#P
PPPP#PPPPP
##PP##PPPP
#PP##P####
PPPPPP#PPP
PPPPP#PP#P
P#P#PPPP#P
PPP###PPPP
