PPPPS##PPP
PP##PP<#PP
PPP##PPPPP
PPPPSP#PPP
P#PPPPP#PP
PPP###PPPP
P#PPP##P#P
P#>PPPPPPP
PP#P#PPPP#
PPPP#PPPP#
