##PPPP#PPP
##PPA##PPP
VPPP#PPPPP
PPPPPP##PP
P##P##PPP#
P##PPPPPPP
PPPPP#PP#P
PPP#PPPP#P
#P###PPPPP
#SSPPPP#PP
