#S####P<##
PPPPPPPPP#
P#PP#P##PP
PPP##PPP#P
S#PPPPPP#P
PPPPPPPPPP
P#PPPPPP##
PPPP#P##VP
PP#P#P##PP
PPPPPPPPPP
