PPPPSPPPP<
P##PPP#PPP
PP#PPPPP#P
>PP#PPPPPP
##PPPPPPP#
##P#####PP
#PPPPP###S
PP#P#P###P
P#PP#P#P<S
PPPP#PPP##
