####PPP###
####P#PP##
#PPPP#PPP#
PP#P#P##PP
P##PPPPP#P
PPSP##>PPP
#PPPPP##PP
#PPP#P#PPP
#PPPPPPPPP
PP#PPPP#PP
