PSVV######
P#PPP#VPPP
PSPPPPPPPP
###P###PPP
##PP##PPP#
##PPPPP#PP
####PPP#PP
########SP
#####PPPPP
#####P#PPP
