#P<##PPPPS
PPPPPP#PP#
P###P###P#
PP#PPPP#PP
PP#PSPPPPP
#P#PP#A##P
PP##P###PP
PPPPPPPPPP
#PP##P#PP#
#PPPPPPPPP
