#PPPPPPPP#
PP#PP#PPP#
P#PPPSP#PP
PPPPPP###P
#PP##PP##P
VPP##PPP#P
PP####PPPP
PP###PPP##
PP##PPP###
PPPPPPP###
