PPP#PPPPPP
PPPSP#P#P#
PPPPPPPPPP
#P##PPPP#P
#P#PPPPPPP
PP#P##P##P
P#>PPPP#PP
PP#PPPP#PP
#PPPPPPPPP
#PPPPP#P#P
