######PPPS
#VPPPPP#PP
#PP######P
#PP#####PP
#PPPP<##PS
#P#PPPPPPP
PS#P##PP#P
PPPPPPPPPP
P#PP##P##P
PPPA##PPPP
