PP#PPP###V
PP#P#PP#PP
PPPP##PPP#
###P#V##P#
PPPPPPPPP#
PP##PP#PPP
P###P##P##
PPP#PPPPPP
PPP##P#PPP
S#PPPPPPSP
