###PS##PS#
#PPP#VPPP#
VP#PPPPPPP
PP#PPPP#PP
PP#PPPPP#P
P##PPP#PPP
P#PP#PPP##
PPP####PPP
P########P
PPPPPPPPPP
