SPP<#PPPPPPPPPPPPPPP
##PSPP##PPP#PPPPP##P
#PPPPPPPP##VP#>PPPPP
PPPAS>PP##PPPP#PSPPP
P###P#PPPPPPPPPPP#SP
PPPPPPP##PP##P#PPPPP
P##PP#PPPPPPPPPPPPPP
PP#PP#PPPPPPPPP#PPP#
#PPPP#P#PPPPP#PPPPPP
#PPPPPP#PPPPPPP####P
#PPP#PPPPPP##P#####P
#PPPP#PP#PPPPPP####P
PPP#PPPP#P#PPPPP#PPP
PPP#PPPPPPP##P#P#PP#
PPPPPP#PPPP##PPP#PPP
P##PPP#PPPP#PPP#PPPP
PP#P#PPP#P#PP##PP###
PPPPP#P###PPP##PP###
#PP#P#PP#PPPP##P####
PP#PP#PPPP#PPPPP####
