#PPPPPPP##
PPP#P##PPP
PPPPPP#PAS
PPPP#P#P#P
#P#PPPPPPP
#P##P#PPPP
PPPPPPPP##
PP#PPPPPPP
#P#PP###PP
PP#PPPPPPP
