PPPPPPPPPP
>PPPPP###P
#PPP#PPPPP
PP#S#PP###
P#PP#PP###
PPP##PP###
PP##PPP###
P##PPSPPP<
PP#PP##PPP
#PPP####PP
