#######S>P
####PPPP#P
##PPPP#PPP
#PPPP####P
PPP#P###PP
P#PPPP#PPP
PPPPPPPPPP
#PPP#PPPP#
#######PPP
#########P
