#PPP<#PSPP
#PPPPPPP#P
PP##PP##PP
PP##PPPPPP
PPP#P#PPPP
PPP#P#PPPP
PPP#PPP#PP
P#P#P#PPPP
PPP#P#P#P#
PP##PPP#PP
