S#SP#PPPP#
PPPPPP#PPP
P##PPPPPPP
PPPPPPP#PP
PP#>PPPPPP
PPP#PP#PP#
P#PP#PPPP#
P##PP#PPP#
P#PPPPPPP<
PPP#PPPPPP
