VS####VPPP
PPPPPPPP#P
PP#P##P#PP
PPPP#PPPP#
SP#PPP#PPP
#P#PP##PPP
#PPPPPP##P
#PPP#PPPPP
##P##P##PP
##PPPPPPPP
