PPPSPP##PP
P#PPP#VPPP
P#PPPPPP##
S>PP###PPP
##P#PPP##P
#PP#P#PPPP
PPP#P#PPP#
P#P#PPPP##
PPPPPPPPP#
PPP#PPPPPP
