PPPPPPPP#P
PP#P#PPPPP
PPPP#PPP##
SP#P#PPPPP
PP#PPP#P#P
#PP#PPPPPP
#PPPP#>P#P
#P#PP##P#P
#PPPPP#P#P
#PP##PPPPP
