P###V#PPPP
PP#PP#P#PP
SPPP##PP#P
##PP#PPPPP
##PPPP###P
PPPP#####P
P###PPPPPP
PP#PP#P###
PPPP##PPPP
PPP###PP#P
