SP##SPPP##
>PPPPP#PP#
#PPPPPP#P#
#PPPPPPPP#
#PPPPP#PPP
##PPP#PPPP
PPPPPPPPPP
P#PPPPP#PP
P#PPPP#PPP
PPP#>P#PPP
