##PPPP###P
#VP##PPPPP
PPPPP#P#PP
P###PPP#PP
###PPPPPPP
PPPPPPPP#P
PPPP###PPP
PPPP##PPPP
#PPPPPP#PP
###PPP###S
