PPPP<#PPPPPP#>PPPP##
>PPPPPPP#P#PPS###PPP
#PPSS#P#PPP#PP###ASA
#PPP#PPP##PP#P#####S
PP#P#PPP###PPPP#PPPP
P#PPPP#P######P#PP##
PPP#PPPPPPPP#PPPPPP#
PPPPP#P##P#PPPPPP#P#
P#P#PP#PPPP#PPPP##PP
PPPP#PPP#PP#P#PPP#PP
#P#PPPPPPPPP###PP#PP
#PPP##P#P##PPPP#P#PP
PPP##PPPPPPP#PPPPPPP
P#P##PP#P#PPPP##PPPP
P#P#PP#PPPP##PPPPPPP
PPP#PPPP#P#PPP#PP#PP
P###PPP##PPP###P#PPP
PP##P#PP#P#####PPP##
PPPP#PPP#PPP##PP####
PP#PPP#PPPPPPPP#####
