S>PP###PPP
P#PPPPPPPP
P#PPPPP##P
PPPP#PPP#P
PP##PPPPPP
PPPPP#P#P#
P#P##PPPPP
PPPP#PP#PP
###PPP#PPP
#####PPPPP
