PPPPPPPPPP
PPP#SSPP#P
#P###VPP#P
PPPP#PPP#P
PPPPPP#P#P
PPA#PP#PPP
PP#PPPPP#P
PPPPPPPPPP
#P#P#P###P
PPPPPPPPPP
