#SPPP##PPP
#PP#PPPP#P
#P###P#PPP
PP#PPP#PP#
#PPPPA#P##
PPP#P#PP##
PP##PPP###
PPP#PPP###
##P##P####
##PPPP####
