#P#VP#SPP#
PP#PPPPPPP
PP#P#PP#PP
P#PPP#PPPP
P###P#PPP#
PPPPP#PPPP
#PP#PPP#PP
##P#PPPPPP
PPPPP##PPP
PPP#PPPPP#
