SPPPPP<###
PPPPPPS###
PPPPP#V###
P###P#PPPP
PPP#PPPP#P
#PP#PP#PP#
PPPPPP#PPP
P#PPPPPPPP
P#PPPP#P#P
PPP#PP#PPP
