PP#PSPP#PPPPPSPPPPP#
SPPPP#PP#####PPP#PPP
#PP#PP#PP#PPPPPPPS#S
##P#PPPPPPPPPPPP#PPP
PPPPP#PP#PPPP#PPPPP#
P###PP#PPPP#P###PPPP
P##PPPPP#PP#PP###PPP
PP#P#PP###PP#PPPPPPP
PPPPPPP###PPPP#PPP#P
#P#P#PP###PPPPPPP#PP
PP#PPPPP##P#PPPPP#P#
PPPPPPPPP#PPP#PPP#PP
P#P#####P#PPPP##PPPP
#PP#####PP#P#PPPP#PP
PP#PPPPP#PPPP###PPPP
PPPPPPPPPP#PPPPPPP#P
#P#P#PPPP##PPPP##PPP
#P#PPPP#PP#P#PPP##P#
#PPPPPPP#P#PP#PPPPPP
#PP####PPP##PPPPPPPP
