PSPPP#PPP#
PP###PP#PP
P####PPPPP
P###PP#PPP
PPPPP#PPP#
#P#PP#P#P#
PP#PP#PPP#
P##PPP##PP
PP#PPPP##P
PPPPPPPPPP
