PPPSP#PPPPPPP##PPPPP
PP##PPPPP#P#P##PP##P
#P#####PPPPSPPSPP##P
#PPSPSPP#PPPPP###PPP
PPPPPPP#PP#P#PPPPPP#
P#P#P#PPP##PPP#PPP##
PPPPP#PP##PPP#P#PP##
PPPPPPPP##P#P#P#PP##
PP###PPPP#P#PPP##PPP
P###PPPPPPPP###PPP#P
PP#PP#PP#PPPPPPPPPPP
PPPP#PPP#P#PPPPPPPPP
PP#P#PPPPP#P###P#PP#
P##PPP#P##PPP#PP#P##
PPPPP##PP#PPPPPP#PP#
PPPP##PP#PPPP#PPPPPP
PPPPP#P##PPPPPP###PP
#PP#PPP#PP####PPPP#P
##P#P##PP#####P#PP#P
##PPPPPP######PPPPPP
