PPP#####PPPP########
#PPP<###P##P########
##PPP#PPP#PP########
####PPP#PPPPP#######
######PPP#PPS##PSPPP
####VPPPPPP#PPPP#SPP
####PP#PPPP####PPPP#
###PP#PPPP#####>P###
PPPP#PP#########P###
PPPPPP##PPPPPP##PP##
#PPPPPPPP###PPP#PP##
#P#P#PP#######PPPP##
PPPP#P#######PP##PPP
PP#PPPP######PP##PPP
PPPPP#PP#####PP#PP#P
PPPPPPPP#####P#PPP#P
PPP##PPPP####PPP##PP
PPP#PP#PPPPPPP###PP#
#P#PP##PPPP##PPP#P##
#PPP####PPP####PPP##
