#PPP##PPS#
#P#P##P#PP
PP#PPPP#P#
P#PP#PPPPP
P#P##PPP#P
P##PPPP#PP
PPPPP#P#PP
PPP##PPPPP
PPPPPP#P#P
PPPPPP#PPP
