#######PPP
######PP#P
#####PP#PP
PPP#PPP#PP
PPPPPP#PP#
P#PPPP#P#P
P#PPPPSP#P
PP##P#P#PP
PPPPP#PPP#
##PPP#PPP#
