##SPPPP#PP
PPPPPPPPPP
P#PPPPPPPP
P#P#PPPPP#
PP###PP#PP
PPP##PSPPP
P#PPPPPPPP
PPPPPPP#PP
#PPPP##PPP
PP##PPPP##
