PPPP######
P#PPPS####
S#PPPP####
PPPP#P####
#PPPPPP###
PP#PP#P###
#P#P#PP###
PPPPPPPPPP
P#P#PP#P#P
PPP#PPPP#P
