#PPP#PPPPP
#PPPSP#PPP
SP##PPPPPP
PP###PP#PP
P###PP#PPP
PP##P##PPP
#P#PPP#P#P
PPPP#PPPPP
PPPP####PP
PPPP#PPPP#
