###PSPPP#P
PPPP###PPP
PP##PPP###
#PPP#PP###
PPPPPPP###
PP##PP#P##
#PPPP#PPPP
PP###PP##P
P#PPPP###P
PPPP#PPPPP
