#PPPPP##PP
PPP##PPPP#
PS##PP#PP#
P##PPPPPP#
P##PPPP###
PPPPPP#PPP
PP##P#PP#P
#PPPP#PP#P
#PP##PPPPP
#PPPPPPPPP
