PPPP#PP#PP
P##P#PS#P#
P##PPPPPP#
PP#PPP##PP
PPPP#PPPPP
#PPPPPPP#P
#PP#P#P#PP
#PS#PPPPP#
PPPPP##PP#
PPPPPPPPP#
