PP####PPPP
PPPPP#P#PP
PP#PPSPPPP
PP#P###PPP
PPPPPP#PP#
P#SP#PP#PP
PPPPP#P#PP
#PP#PPP#PP
PPPP#P#PPP
P##PPPPPP#
