P#PPPPPPP#
PPP##P##PP
P#PP#PPPPP
P#PPPPPPPP
PP#PPSPP#P
#PPP#PPPPP
PP##PPPP##
P#PPPPPPPP
P#P##PPP#P
PPP###PPPP
