PPP#######
PPPP######
P##PPPP###
PPS##PPP##
PSP#PP#PPP
PPP#PP##PP
P###PP##PP
PPPPPPPPPP
#PPPSPP###
##PPPP####
