PPPPPPPP##
PPPSPPPPS#
>PPPP##PPP
#P#PP####A
#PPPPPP<#S
#PP##PPPPP
#P#PPP####
PPPPP#####
P#P#######
PPP#######
