P###P#PP##
SPPPP#PPP#
P#PPPPPPPP
PPPPP#PPPP
PP#PPPPPPP
PPPP#P#PPP
#PPPPPPP##
PPPPPPPPP#
PP#PPPPPP#
PP#PSP#PPP
