PP#PPP####
#SPPPP####
PP##PPP###
PP#PP#PP##
PP#P#PP#PP
PP#PPPPPPP
P#PP#PPPPP
P#PPPPPP#P
PP#PPP#PPP
#PPP######
