PPPP###PPP
PPPPP#PPPP
PPP#PP###P
PP###PP##P
#PPS#PP#PP
PP#PPPP#P#
P###PPPPPP
PPP#P#PPPP
#PPPP#PPPS
##PP###PPP
