###PPP#PPS
PPPP#PPPP#
PP######PP
SP######PP
PP#######P
P####P##PP
P####PP#P#
PPP###P#P#
PPPPPPPPS#
#PPPPPPPPP
