PPPPP####P
SP##PPP#PP
PPP#P#PPP#
PPP#PPPPP#
PPPPPPPPPP
PPPPPP#PPP
PPP#PPPP#P
P#P###PPPS
P#PPPP#P##
PPP#PPPPPP
