PPPP#PSPP#
PP#P#P#PPP
P##P#PSPPP
PPPPPPPPPP
PP##PPP##P
PPP#PPPPPP
PPPPP###P#
PPP#P###PP
#P#PPPPPPP
#PPPP#PP##
