#PPPPP##P#
PPP#SPPPP#
PPPPPPPP##
PP####P#PP
PP#S##PPPP
#P####P###
PP###PP###
PPPP#PP###
##PPPSP###
####PPP###
