##SSPPPPPP
#PPPP#S#PP
#PPPPPP#PP
PPPPPPPPP#
PP#P#PP###
PPPPPPPP##
P#PPPPPPP#
PPPPPP##P#
#P#PPP##PP
#PPPP###PP
