#PPPPPP##P
#SP#PPPPPP
#PPP#PPPPP
##PPPPP###
#####SP###
####PPP###
####P#PPPP
###PPPP##P
###P#PP#PP
###SPP##PP
