PPPPPPPPPP
PPP###PPP#
####PPP#PP
####P#PSPP
####PPPPPP
####PPP###
###PPP#PPP
###PPP#P#P
###P#PP#PP
###PP#PPP#
