PPP##PPP##
P#PPPPSP##
#PP#P##PPP
#S##PPPP#P
#PPP##P##P
#P#PPPPP#P
PPPPPPPP#P
P#PPP#PP#P
PP#PPPPPPP
PP#PPP#PPP
