S#PPP#PPP#
PPP#PPP#PP
PPPPP####P
P####PPPPP
PP###PPPPP
#PP#PPPPP#
#PPPP#PPP#
##P#PPPPPP
PPP##P#P#P
PPPP#PPPPP
