PSPPP#####
PPP#PP####
P####PPPP#
PP#PPPPPPP
#PPPP##PPP
#PP#PP#P#P
#P##PPP#PP
#PPPP##PP#
##P###PPP#
##PPPPP###
