PPP###PP#P
PPPP#PPPPP
P##PPPP###
PPP#PP####
#PPPP#####
#PP#PPS###
PPPPPP####
PPP#PP####
PP##PP####
PPPPPP####
