#PPP#PPP#PPPPPPPPPPP
PP#PPPPPPPP##P#PP#P#
PS######PPPP#PPPPPPP
PPPPPP##P##P#P#PP#PP
PP#PPP##PPPPP##PPPPP
PPPP#PPPP#P#P###P#P#
PP#PP#PPP##PPP##SPPP
PP##PPP#P##P#PPPPPPP
#PPPP###PP#PPSP#PPPP
PP#P####P##PP#P#PPP#
PPPPP#PPPPPPPPPPPPPP
PPS#PPPPSP###PPPP#P#
PPP#P#P##PPPPP#PPPPP
##PP#PPP#PPP#PPP#PPP
PP#PPP#PPPPPPP#PPP#P
#PPPP###PPPP#P##P##P
PPPPP##PPP##PPPPP#PP
PPP#PPPP##PPP#PP#PP#
P#PP#PPP##P#PPP#PP##
PPPPPPPPPPP##PPPP###
