##PPPPPPPP
##P#P#P##P
PPPPPPPPPP
P#PP#PP#PP
PP#PPPPPPP
SPPP#PP##P
PP#PPP##PP
#P#PPPP#PP
PPPPP#P#PP
P##PPPP#PP
