P####PPPPP
PPPPPP##PP
###P#PP#SP
PPPPPPPPPP
P#PP#P##P#
PP##PP##PP
PPPPPPPP#P
#PP#PP##PP
##P#PPPPP#
##PPP#PPPP
