PP#SPPPP#P
PPPP#PPPPP
####PP##P#
#####PPPP#
#####P#PP#
####PPPP#P
PPPPPPPP#P
PPPPPPPPPP
###PPP#P##
PPPP#PPPPP
