##PPPPPSP#
#PP#PPPPP#
PPP#PP#PPP
PPPP#P#PP#
#PPPPPP#PP
PP#PPPPPPP
P##PP#PP#P
PPPPPP#PSP
#PPPP##P##
###PPPPP##
