PPP#SPPP##
P#PP#PPPPP
P##P#P##PP
PP#PPPP#P#
PPPPPPP#PP
##PPP#PPPP
PPP#PPPPPP
P#PPP#####
PP#P#PPPPP
#P#PPPP##P
