S#PPPPSPP#
PPP##PPPPP
PPPPP#P##P
PPP#P#PPPP
PP#PPPPPP#
PPP###PPPP
P#PP##PPPP
PP#PPPP##P
PPPP#PPPPP
##PP####PP
