PPPPPPPPP#
PPPPP#PPPP
P##PPPP#PP
##PPPP##P#
PPPPPPPPPP
P##PPPPP#P
PPSPPPPP##
PP##PP#PPP
#PPPPPP##P
#PPPPPPPPP
