PPP#PPPPPS
PPP#PP#PPP
PPPPP#PPPP
P#P#PSPPPP
PPP#P#P###
PP##PPPPPP
PPPPPP#P#P
P#PPPPPP#P
P#PPPP##PP
PPPP#PPPPP
