######PPPS
#####PPP#P
#####PP##P
PPP#PP#PPP
P#PPPPPP#P
PP#P##PPPP
PPPP#SPPSP
##PP##PPPP
###P######
###PPPPPPP
