PPP##PPPPS
PPP#PP#P##
##PPPP#PP#
###P#PPPP#
##SPP###PP
#PP#PPPP#P
#PP#PPPPPP
PP#PP#P#PP
PP#P##PPPP
PPPP#PPPPP
