#PPPPPPSPP
#P####PPPP
#PPP##PPPP
##PPPPP#PP
##P#PPPP##
##PPPP#PPP
#PP######P
PP#####P#P
PPPPPPPPPP
###P#PP###
