#PPP####PP
#P#####PPP
SP##PPPPP#
#P##PPPPPS
#P##P#PSP#
PP##PPP#PP
PPPPP###PP
PPPPPPP#P#
######P#P#
######PPP#
