####PPPPPPP#########
##PPS#PP##PP########
PPP#PPPP##PPPPPPPPPP
PP##P#PPPPP#PPP##P#P
PPPPPPPPPPPPP##PPPPP
#PPPSPPPPP#PPPPP####
###PP#P#####PPPP####
####PPPPPPPPPPPS####
###PP#PPPP#P#PPP####
###P##PPPPPP###PP###
###PP#PPPPP####PP###
###PP##PPPP####PP###
###PPPPP#######PP###
##PP#PP#########PPPP
#PPPPP##########PPPP
#PP#PPP#########PPPP
PP##PPP#PP#####PPPPP
PP##PPPPPP#####PPPP#
PP#PP####PP####P####
PPPP######PPPPPP####
